AboutYou	QHousehold.QHHold.Person[*].FstNme
ABSWK	QIndiv[*].QSickness.ABSWK
ACCDNT	QIndiv[*].QAccidAtWork.Accdnt
accident_which_job_unemployed	QIndiv[*].QAccidAtWork.accident_which_job_unemployed
ACCKIND	QIndiv[*].QAccidAtWork.AccKind
ACCKIND_OTHER	QIndiv[*].QAccidAtWork.AccKindOth
ACCURH	QIndiv[*].QAccidAtWork.AccurH
ACTHR	QIndiv[*].QEmploy.ActHr_Hours
ACTHR1	QIndiv[*].QEmploy.ActHr1_Hours
ACTHR2	QIndiv[*].QEmploy.ActHr2_Hours
actual_unpaid_family_worker_hours	QIndiv[*].QEmploy.actual_unpaid_family_worker_hours
ACTWKDY	QIndiv[*].QSickness.ACTWKDY
ACTWKDY_Proxy	QIndiv[*].QSickness.ActWkdyProx
Add_College	QIndiv[*].QEdu.Add_College
Add_College_EWNISCOT	QIndiv[*].QEdu.Add_College_EWNISCOT
Add_Dip_Age	QIndiv[*].QEdu.Add_Dip_Age
Add_HE	QIndiv[*].QEdu.Add_HE
Add_leavers	QIndiv[*].QEdu.Add_leavers
Add_NonUK_Deg	QIndiv[*].QEdu.Add_NonUK_Deg
Add_NonUK_School	QIndiv[*].QEdu.Add_NonUK_School
Add_Other_Qual	QIndiv[*].QEdu.Add_Other_Qual
Add_Other_Qual_NonUK	QIndiv[*].QEdu.Add_Other_Qual_NonUK
Add_Other_Uni_Lev	QIndiv[*].QEdu.Add_Other_Uni_Lev
Add_Prof	QIndiv[*].QEdu.Add_Prof
Add_Qual	QIndiv[*].QEdu.Add_Qual
Add_Qual_EWNISCOT	QIndiv[*].QEdu.Add_Qual_EWNISCOT
Add_Qual_NonUK	QIndiv[*].QEdu.Add_Qual_NonUK
Add_Qual_Scot	QIndiv[*].QEdu.Add_Qual_Scot
Add_School	QIndiv[*].QEdu.Add_School
Add_School_EWNISCOT	QIndiv[*].QEdu.Add_School_EWNISCOT
Add_Scot_School	QIndiv[*].QEdu.Add_Scot_School
Add_Uni	QIndiv[*].QEdu.Add_Uni
Add_Uni_EWNISCOT	QIndiv[*].QEdu.Add_Uni_EWNISCOT
AddChk1	QInfoSheet.AddChk1
AddPpl	QHousehold.QHHold.Person[*].FstNme
AddressChk	QHousehold.QHHold.Person[*].AddressChk
AddrHist_Check	QIndiv[*].QAddrHist.AddrHistCheck
AddrHist_Date	QIndiv[*].QAddrHist.QAddress[**].Month
AddrHist_Intro	Skip
AddrHist_manual	QIndiv[*].QAddrHist.QAddress[**].AddrNum
AddrHist_same	QIndiv[*].QAddrHist.AddrHistSame
AddrHist_Year	QIndiv[*].QAddrHist.QAddress[**].Year
AddStu	QHousehold.QHHold.Person[*].FstNme
AddStuChk	QHousehold.QHHold.Person[*].AddStuChk
AFRICAN_SC	QIndiv[*].QEthnic.EthAfrica
AFRICAN_SC_OTH	QIndiv[*].QEthnic.EthAfrOth
Age	QHousehold.QHHold.Person[*].AgeIf
Alev_Tlev	QIndiv[*].QEdu.Alev_Tlev
AltAdd	QIndiv[*].QLiveHere.AltAdd
AltAddressChk	QHousehold.QHHoldConfirm.AltAddChk
AltAddType	QIndiv[*].QLiveHere.AltAddType
AltIndivStart	Skip
ANBANDS1A	QIndiv[*].QEarnings.AnBands1A
ANBANDS1B	QIndiv[*].QEarnings.AnBands1B
ANBANDS2	QIndiv[*].QEarnings.AnBands2
ANBANDS3	QIndiv[*].QEarnings.AnBands3
ANXIOUS	QIndiv[*].QWellbeing.Anxious
App_Lev	QIndiv[*].QEdu.App_Lev
App_Location_EWNISCOT	QIndiv[*].QEdu.App_Location_EWNISCOT
AppCurr	QIndiv[*].QCourse.AppCurr
apprenticeship_sic_2007_industry	QIndiv[*].QCourse.apprenticeship_sic2007_industry
apprenticeship_soc2020_job_title	QIndiv[*].QCourse.apprenticeship_soc2020_job_title
apprenticeship_main_job	QIndiv[*].QCourse.apprenticeship_main_job
ASIAN	QIndiv[*].QEthnic.EthAsian
ASIAN_OTH	QIndiv[*].QEthnic.EthAsnOth
ASIAN_SC	QIndiv[*].QEthnic.EthAsianScot
Attend	QIndiv[*].QCourse.Attend
ATTEND18	QIndiv[*].QEducat.Attend18
AWARE	QIndiv[*].QWorkRelatedIll.AWARE
Bacc_Type	QIndiv[*].QEdu.Bacc_Type
Bacc_WSI	QIndiv[*].QEdu.Bacc_WSI
Band1	QIndiv[*].QEarnings.Band1
Band2	QIndiv[*].QEarnings.Band2
Band3	QIndiv[*].QEarnings.Band3
BEC_Lev	QIndiv[*].QEdu.BEC_Lev
BENEFITOTH	QIndiv[*].QBenefits.BenefitOth
BLACK	QIndiv[*].QEthnic.EthBlack
BLACK_OTH	QIndiv[*].QEthnic.EthBlkOth
BROADBANDA	QIndiv[*].QEmploy.BroadbandA
BROADBANDB	QIndiv[*].QEmploy.BroadbandB
BTEC_1_Type	QIndiv[*].QEdu.BTEC_1_Type
BTEC_2_Date	QIndiv[*].QEdu.BTEC_2_Date
BTEC_3_Date	QIndiv[*].QEdu.BTEC_3_Date
BTEC_3_Type	QIndiv[*].QEdu.BTEC_3_Type
BTEC_3_Type2	QIndiv[*].QEdu.BTEC_3_Type2
BTEC_3_Type3	QIndiv[*].QEdu.BTEC_3_Type3
BTEC_4_Lev	QIndiv[*].QEdu.BTEC_4_Lev
BTEC_4_Type	QIndiv[*].QEdu.BTEC_4_Type
BTEC_4_Type2	QIndiv[*].QEdu.BTEC_4_Type2
BTEC_5_A	QIndiv[*].QEdu.BTEC_5_A
BTEC_5_DA	QIndiv[*].QEdu.BTEC_5_DA
BTEC_5_HA	QIndiv[*].QEdu.BTEC_5_HA
BTEC_5_Type	QIndiv[*].QEdu.BTEC_5_Type
BTEC_Af2012	QIndiv[*].QEdu.BTEC_Af2012
BTEC_EL_Type	QIndiv[*].QEdu.BTEC_EL_Type
BTEC_Lev	QIndiv[*].QEdu.BTEC_Lev
BTEC_Lev1_2	QIndiv[*].QEdu.BTEC_Lev1_2
BTEC_Number	QIndiv[*].QEdu.BTEC_Number
BTEC_pre2012	QIndiv[*].QEdu.BTEC_pre2012
BTEC_Prof_Lev2_award	QIndiv[*].QEdu.BTEC_Prof_Lev2_award
BTEC_Prof_Lev2_certs	QIndiv[*].QEdu.BTEC_Prof_Lev2_certs
BTEC_Prof_Lev2_diplomas	QIndiv[*].QEdu.BTEC_Prof_Lev2_diplomas
BTEC_Type	QIndiv[*].QEdu.BTEC_Type
Cambridge_Qual	QIndiv[*].QEdu.Cambridge_Qual
CAMEMT	QIndiv[*].QCntryBrth.CameMt
CAMEYR	QIndiv[*].QCntryBrth.CameYrInPer
CAMEYR_Proxy	QIndiv[*].QCntryBrth.CameYrProxy
CAMEYR2	QIndiv[*].QCntryBrth.CameYr2
career_progression_main_job	QIndiv[*].QJobQual.career_progression_main_job
CARIBBEAN scottish	QIndiv[*].QEthnic.EthCarib
CARIBBEAN_SC_OTH	QIndiv[*].QEthnic.EthCarOth
CASAC	QIndiv[*].QEmploy.CasAc_Hours
CasualJob_EDU	QIndiv[*].QCourse.CasualJob20
CasualJob20	QIndiv[*].QUnemploy.CasualJob20
CASWRK18	QIndiv[*].QUnemploy.CasWrk18
CG_Size	QIndiv[*].QEdu.CG_Size
CG_Type	QIndiv[*].QEdu.CG_Type
Chart_Type	QIndiv[*].QEdu.Chart_Type
check_total_actual_work_second_2job	QIndiv[*].QEmploy.check_total_actual_work_second_2job
check_total_usual_work_1job	QIndiv[*].QEmploy.check_total_usual_work_1job
check_total_usual_work_main_2job	QIndiv[*].QEmploy.check_total_usual_work_main_2job
check_total_usual_work_second_2job	QIndiv[*].QEmploy.check_total_usual_work_second_2job
CheckPage
CheckText
CIGEVER	QIndiv[*].QSmoking.CIGEVER
CIGNOW	QIndiv[*].QSmoking.CIGNOW
Comment
CONF	Skip
CONMON1	QIndiv[*].QEmploy.ConMon1
CONMON2	QIndiv[*].QEmploy.ConMon2
CONMPY	QIndiv[*].QEmploy.ConMPY
CONSEY	QIndiv[*].QEmploy.ConSEY
CONTAB	QIndiv[*].QSickness.CONTAB
CONTRACTMAINJOB20	QIndiv[*].QEmploy.Contract_MainJob20
CONTUK	QIndiv[*].QCntryBrth.ContUK
Core_Skills	QIndiv[*].QEdu.Core_Skills
Country_Qual	QIndiv[*].QCourse.Country_Qual
Country_Qual_Intro	Skip
Course	QIndiv[*].QCourse.Course
COURSE18	QIndiv[*].QEducat.Course18
CRY12	Placeholder as it is country based but the command is good
CRY12_en	QIndiv[*].QCntryBrth.Cry12E
CRY12_ni	QIndiv[*].QCntryBrth.Cry12N
CRY12_Other	QIndiv[*].QCntryBrth.Cry12Oth
CRY12_sco	QIndiv[*].QCntryBrth.Cry12S
CRY12_UK	QIndiv[*].QCntryBrth.QBornUK.Cry12WUK
CRY12EUK	QIndiv[*].QCntryBrth.QBornUK.Cry12EUK
CRY12SUK	QIndiv[*].QCntryBrth.QBornUK.Cry12SUK
CRY12WUK	QIndiv[*].QCntryBrth.QBornUK.Cry12WUK
CRY12_wal	QIndiv[*].QCntryBrth.Cry12W
CRY120th_OTH	QIndiv[*].QCntryBrth.Cry12Oth
CT_2_Type	QIndiv[*].QEdu.CT_2_Type
CT_3_Type	QIndiv[*].QEdu.CT_3_Type
current_conditions_other	QIndiv[*].QHealth.current_conditions_other
current_joint_bone_muscle_conditions	QIndiv[*].QHealth.current_joint_bone_muscle_conditions
current_mental_health_condition	QIndiv[*].QHealth.current_mental_health_conditions
current_neurodivergent_conditions	QIndiv[*].QHealth.current_neurodivergent_conditions
Current_passport_check	QIndiv[*].QPassport.Current_passport_check[**]
Current_Passports	QIndiv[*].QPassport.Current_Passports
current_progressive_relapsing_remitting_conditions	QIndiv[*].QHealth.current_progressive_relapsing_remiting_conditions
current_sensory_problems	QIndiv[*].QHealth.current_sensory_problems
current_study_for_qual	QIndiv[*].QCourse.current_study_for_qual
CYMFREQ	QIndiv[*].QWelsh.OftSpeak
day_work_ever_main_job	QIndiv[*].QEmploy.day_work_ever_main_job
Deg_App	QIndiv[*].QEdu.Deg_App
DEPCONT20	QIndiv[*].QEmploy.DepCont20
DEPCONT21	QIndiv[*].QEmploy.DepCont21
DEPCONT22	QIndiv[*].QEmploy.DepCont22
DIFPER	QIndiv[*].QSickness.DIFPER
Dip_14_19	QIndiv[*].QEdu.Dip_14_19
Dip_Age	QIndiv[*].QEdu.Dip_Age
DOB	QHousehold.QHHold.Person[*].Day
ECAUTH20	QIndiv[*].QEmploy.EcAuth20
ECAUTH21	QIndiv[*].QEmploy.EcAuth21
ECAUTH22	QIndiv[*].QEmploy.EcAuth22
Edexcel_Lev	QIndiv[*].QEdu.Edexcel_Lev
Education_OUTRO	Skip
employees_decision_involvement_main_job	QIndiv[*].QJobQual.employees_decision_involvement_main_job
EMPLOYEES20	QIndiv[*].QEmploy.Employees20
EMPLOYEES21	QIndiv[*].QEmploy.Employees21
EMPLOYEES22	QIndiv[*].QEmploy.Employees22
Employment_Intro	QIndiv[*].QUnemploy.Intro
employment_status_previous	QIndiv[*].QPrevIndOCc.employment_status_previous
EMPSICK4	QIndiv[*].QSickness.EMPSICK4
Enrol	QIndiv[*].QCourse.Enrol
Enrol_Check	QIndiv[*].QCourse.Enrol_Check
EssSkills_Lev	QIndiv[*].QEdu.EssSkills_Lev
Ethnicity	Split down into countries
Ethnicity_en	QIndiv[*].QEthnic.EthnicEngWal
Ethnicity_ni	QIndiv[*].QEthnic.EthnicNI
Ethnicity_sco	QIndiv[*].QEthnic.EthnicScot
Ethnicity_wal	QIndiv[*].QEthnic.EthnicEngWal
evening_work_ever_main_job	QIndiv[*].QEmploy.evening_work_ever_main_job
evening_work_frequency_main_job	QIndiv[*].QEmploy.evening_work_frequency_main_job
ever_sought_asylum	QIndiv[*].QCntryBrth.ever_sought_asylum_refuge
EVEROT	QIndiv[*].QEmploy.EverOT
EVEROT_INT1	QIndiv[*].QEmploy.EverOT_Int1
EVEROT_INT2	QIndiv[*].QEmploy.EverOT_Int2
EWNI_AddCol_Other	QIndiv[*].QEdu.EWNI_AddCol_Other
EWNI_Additional	QIndiv[*].QEdu.EWNI_Additional
EWNI_AddProf_Other	QIndiv[*].QEdu.EWNI_AddProf_Other
EWNI_AddSch_Other	QIndiv[*].QEdu.EWNI_AddSch_Other
EWNI_AddUni_Other	QIndiv[*].QEdu.EWNI_AddUni_Other
EWNI_College	QIndiv[*].QEdu.EWNI_College
EWNI_Prof	QIndiv[*].QEdu.EWNI_Prof
EWNI_School	QIndiv[*].QEdu.EWNI_School
EWNI_Uni	QIndiv[*].QEdu.EWNI_Uni
EWNISc_AddSch_Other	QIndiv[*].QEdu.EWNISCOT_AddSch_Other
EWNISCOT_Add_Uni_Other	QIndiv[*].QEdu.EWNIScot_AddUni_Other
EWNISCOT_AddCol_Other	QIndiv[*].QEdu.EWNISCOT_AddCol_Other
EWNISCOT_Additional	QIndiv[*].QEdu.EWNISCOT_Additional
EWNISCOT_College	QIndiv[*].QEdu.EWNISCOT_College
EWNISCOT_CoreSkills	QIndiv[*].QEdu.EWNISCOT_CoreSkills
EWNISCOT_EssSkills	QIndiv[*].QEdu.EWNISCOT_EssSkills
EWNISCOT_FuncSkills	QIndiv[*].QEdu.EWNISCOT_FuncSkills
EWNISCOT_HE	QIndiv[*].QEdu.EWNISCOT_HE
EWNISCOT_KeySkills	QIndiv[*].QEdu.EWNISCOT_KeySkills
EWNISCOT_SBacc	QIndiv[*].QEdu.EWNISCOT_SBacc
EWNISCOT_School	QIndiv[*].QEdu.EWNISCOT_School
EWNISCOT_Skills	QIndiv[*].QEdu.EWNISCOT_Skills
EWNISCOT_Wbacc	QIndiv[*].QEdu.EWNISCOT_Wbacc
Expired_passport_check	QIndiv[*].QPassport.Expired_passport_check[**]
Expired_Passports	QIndiv[*].QPassport.Expired_Passports
Feedback	QOutro.Feedback
Feedback_TO	QOutro.Feedback
FIFSAL18	QIndiv[*].QEmploy.FIFSal18
FTPT	QIndiv[*].QEmploy.FTPT
FTPT1	QIndiv[*].QEmploy.FTPT1
FTPT2	QIndiv[*].QEmploy.FTPT2_18
FuncSkills_Lev	QIndiv[*].QEdu.FuncSkills_Lev
future_work_related_education_3months	QIndiv[*].QCourse.future_work_related_education_3months
future_work_related_education_4weeks	QIndiv[*].QCourse.future_work_related_education_4weeks
GCSE_Grades	QIndiv[*].QEdu.GCSE_Grades
GCSE_OLev_Check	QIndiv[*].QEdu.GCSE_OLev_Check
GCSE_Olevs	QIndiv[*].QEdu.GCSE_Olevs
Gender_Identity	QIndiv[*].QSID.Gender_Identity
Gender_Identity_Oth	QIndiv[*].QSID.Gender_Identity_Oth
GNVQLevel	QIndiv[*].QEdu.GNVQLevel
GOBCK9	QIndiv[*].QAccidAtWork.GoBck9
Grad_App_Lev	QIndiv[*].QEdu.Grad_App_Lev
Grs1A	QIndiv[*].QEarnings.Grs1A
Grs1B	QIndiv[*].QEarnings.Grs1B
Grs2	QIndiv[*].QEarnings.Grs2
GrsExp	QIndiv[*].QEarnings.GrsExp
GrsSkp	QIndiv[*].QEarnings.GrsSkp
GrsSkp1A	QIndiv[*].QEarnings.GrsSkp1A
GrsSkp1B	QIndiv[*].QEarnings.GrsSkp1B
GrsSkp2	QIndiv[*].QEarnings.GrsSkp2Web
GrsSkp2A	QIndiv[*].QEarnings.GrsSkp2AWeb
GrsSkp2A_tel	QIndiv[*].QEarnings.GrsSkp2A
GrsSkp2B	QIndiv[*].QEarnings.GrsSkp2B
GrsSkpA	QIndiv[*].QEarnings.GrsSkpA
GSVQ_GNVQ_Lev	QIndiv[*].QEdu.GSVQ_GNVQ_Lev
GSVQ_Lev	QIndiv[*].QEdu.GSVQ_Lev
HAPPY	QIndiv[*].QWellbeing.Happy
HEAL20	QIndiv[*].QHealth.Heal20
HEALPB	QIndiv[*].QHealth.HealPb
health_condition_illness_12months	QIndiv[*].QHealth.Health_condition_illness_12months
HEALYR	QIndiv[*].QHealth.HealYr
HH_refday	QIndiv[*].QAddHH.HH_Refday
HH_refday_AddHold	QIndiv[*].QAddHH.Person[**].FstNme
HH_refday_AddHold_Age	QIndiv[*].QAddHH.Person[**].AddHoldAge
HH_refday_AddHoldCheck	QIndiv[*].QAddHH.Person[**].AddHoldCheck
HH_refday1	QIndiv[*].QAddHH.HH_Refday1
HH_refday2	QIndiv[*].QAddHH.HH_Refday2
HHKickOut	Skip
HholdChk	QHousehold.QHHold.Person[*].AnyoneElse
HholdChk2	QHousehold.QHHold.Person[*].HHoldChk2
HholdChkAlt	QHousehold.QHHold.Person[*].HHoldChkAlt
Higher_App	QIndiv[*].QEdu.Higher_App
HOME	QIndiv[*].QEmploy.Home
HOMEEV	QIndiv[*].QEmploy.HomeEv
HOMEREF	QIndiv[*].QEmploy.HomeRef
Household_Intro	Skip
HRLYBANDS1A	QIndiv[*].QEarnings.HrlyBands1A
HRLYBANDS1B	QIndiv[*].QEarnings.HrlyBands1B
HRLYBANDS2	QIndiv[*].QEarnings.HrlyBands2
HRLYBANDS3	QIndiv[*].QEarnings.HrlyBands3
HRP	QHousehold.QHHoldConfirm.HRP
HTHDIS	QIndiv[*].QPrevIndOCc.HthDisPers
HTHDIS_PROXY	QIndiv[*].QPrevIndOCc.HthDis
HTHOTH	QIndiv[*].QPrevIndOCc.HthOthPers
HTHOTH_PROXY	QIndiv[*].QPrevIndOCc.HthOth
HTHRES	QIndiv[*].QPrevIndOCc.HthResPers
HTHRES_PROXY	QIndiv[*].QPrevIndOCc.HthRes
HTHRET	QIndiv[*].QEmploy.QPrevIndOCc.HthRetPers
HTHRET_PROXY	QIndiv[*].QEmploy.QPrevIndOCc.HthRet
HWRET12E	QIndiv[*].QSickness.HWRET12E
HWRET12S	QIndiv[*].QSickness.HWRET12S
IL1BEF	QIndiv[*].QSickness.IL1BEF
IL2BEF	QIndiv[*].QSickness.IL2BEF
ILCURR	QIndiv[*].QWorkRelatedIll.ILCURR
ILL1PD	QIndiv[*].QSickness.ILL1PD
ILLDAYS	QIndiv[*].QSickness.IllDays
ILLFST20	QIndiv[*].QSickness.ILLFST20
ILLNXT20	QIndiv[*].QSickness.ILLNXT20
ILLST17	QIndiv[*].QSickness.ILLST17
ILLWK	QIndiv[*].QSickness.ILLWK
ILLWRK1	QIndiv[*].QWorkRelatedIll.ILLWRK1
ILLWRK2	QIndiv[*].QWorkRelatedIll.ILLWRK2
ILNE12SE	QIndiv[*].QSickness.ILNE12SE
ILNE20	QIndiv[*].QSickness.ILNE20
ILNE20M	QIndiv[*].QSickness.ILNE20M
ILNXSM	QIndiv[*].QSickness.ILNXSM
in_job_bullying_12months	QIndiv[*].QJobQual.in_job_bullying_12months
in_job_bullying_frequency_12months	QIndiv[*].QJobQual.in_job_bullying_frequency_12months
INCORP20	QIndiv[*].QEmploy.InCorp20
INCORP21	QIndiv[*].QEmploy.InCorp21
INCORP22	QIndiv[*].QEmploy.InCorp22
IndIntroPage	Skip
Individual_OUTRO	Skip
IndivIntroPage	Skip
IneligibleOther	QHousehold.QHHold.Person[*].IneligOth
IneligibleOutro	Skip
IneligibleType	QHousehold.QHHold.Person[*].IneligType
Intermediates_Lev	QIndiv[*].QEdu.Intermediates_Lev
INTUSE	QIndiv[*].QInternet.IntUsePersonal
INTUSE_Proxy	QIndiv[*].QInternet.IntUse
JbRoleChg	QIndiv[*].QEmploy.JbRoleChg
JOBPRO	QIndiv[*].QJobQual.career_progression_main_job
JobQual_Intro	Skip
Jobtyp18	QIndiv[*].QEmploy.JobTyp18
Jobtyp18_Oth	QIndiv[*].QEmploy.JobTyp18Oth
JSATYP	QIndiv[*].QBenefits.JSATYP
Key_Skills	QIndiv[*].QEdu.Key_Skills
Key_Skills_Scot	QIndiv[*].QEdu.Key_Skills_Scot
LabourMarket_Intro	Skip
Last_expired_passport_message	Skip
Last_passport_message	Skip
LastPerMessage	Skip
LEFTYR18	QIndiv[*].QUnemploy.LeftYr
LEFTYR18_Catch	QIndiv[*].QEmploy.QCatchUnemp.ctchLeftM
LERND	QIndiv[*].QHealth.LernD
like_paid_job	QIndiv[*].QUnemploy.like_paid_job
LIMACT	QIndiv[*].QHealth.LimAct
LIMITA	QIndiv[*].QHealth.LimitA
LIMITK	QIndiv[*].QHealth.LimitK
LKTIMA	QIndiv[*].QUnemploy.LkTimAMth
LKTIMA_Catch	QIndiv[*].QEmploy.QCatchUnemp.ctchLkTimAMth
LKTIMB	QIndiv[*].QUnemploy.LkTimBMth
LKTIMB_Catch	QIndiv[*].QEmploy.QCatchUnemp.ctchLkTimBMth
LNGLST	QIndiv[*].QHealth.LngLst
LNGLST12	QIndiv[*].QHealth.LngLst12
longer_hours_at_current_pay_main_job	QIndiv[*].QOverUnderEmp.longer_hours_at_current_pay_main_job
longer_hours_offered_start_in_2weeks_main_job	QIndiv[*].QOverUnderEmp.longer_hours_offered_start_in_2weeks_main_job
longer_hours_offered_start_in_2weeks_self_employed	QIndiv[*].QOverUnderEmp.longer_hours_offered_start_in_2weeks_self_employed
LOOK4_18	QIndiv[*].QUnemploy.Look4_18
LOOK4_18_Catch	QIndiv[*].QEmploy.QCatchUnemp.ctchLook4_18
looking_for_different_paid_job	QIndiv[*].QOverUnderEmp.looking_for_different_paid_job
looking_for_new_main_job_preferred_hours	QIndiv[*].QOverUnderEmp.looking_for_new_main_job_preferred_hours
looking_for_new_main_job_reasons	QIndiv[*].QOverUnderEmp.looking_for_new_main_job_reasons
looking_for_paid_job_type	QIndiv[*].QOverUnderEmp.looking_for_paid_job_type
main_health_condition	QIndiv[*].QHealth.main_health_condition
main_job_work_pattern_type	QIndiv[*].QEmploy.main_job_work_pattern_type
manager_support_main_job	QIndiv[*].QJobQual.manager_support_main_job
managerial_duties_1job	QIndiv[*].QEmploy.managerial_duties_1job
managerial_duties_main_2job	QIndiv[*].QEmploy.managerial_duties_main_2job
managerial_duties_second_2job	QIndiv[*].QEmploy.managerial_duties_second_2job
MargAtch	QIndiv[*].QUnemploy.MargAtch
MAX_PEOPLE	Skip
meaningful_main_job	QIndiv[*].QJobQual.meaningful_main_job
MINHRS	QIndiv[*].QEmploy.MinHrs18
MINHRS18	QIndiv[*].QEmploy.MinHrs18
MIXED	QIndiv[*].QEthnic.EthMix
MIXED_OTH	QIndiv[*].QEthnic.EthMixOth
MNSBANDS1A	QIndiv[*].QEarnings.MnsBands1A
MNSBANDS1B	QIndiv[*].QEarnings.MnsBands1B
MNSBANDS2	QIndiv[*].QEarnings.MnsBands2
MNSBANDS3	QIndiv[*].QEarnings.MnsBands3
Modern_App_Lev	QIndiv[*].QEdu.Modern_App_Lev
Multi_current_passport	QIndiv[*].QPassport.Multi_current_passport[**]
Multi_expired_passport	QIndiv[*].QPassport.Multi_expired_passport[**]
NATID	Split down to countries
NATID Other	QIndiv[*].QNation.NatIDSpec
NATID_en	QIndiv[*].QNation.NatldE
NATID_ni	QIndiv[*].QNation.NatldN
NATID_Oth	QIndiv[*].QNation.NatIDSpec
NATID_sco	QIndiv[*].QNation.NatldS
NATID_wal	QIndiv[*].QNation.NatldW
Nationality	QIndiv[*].QCntryBrth.Nation
Nationality_Oth	QIndiv[*].QCntryBrth.NationOth
Nationals_Lev	QIndiv[*].QEdu.Nationals_Lev
Nationals_Type	QIndiv[*].QEdu.Nationals_Type
night_work_ever_main_job	QIndiv[*].QEmploy.night_work_ever_main_job
night_work_frequency_main_job	QIndiv[*].QEmploy.night_work_frequency_main_job
NITAX20	QIndiv[*].QEmploy.NITax20
NITAX21	QIndiv[*].QEmploy.NITax21
NITAX22	QIndiv[*].QEmploy.NITax22
NOACT0	QIndiv[*].QEmploy.noact0
NOACT1	QIndiv[*].QEmploy.noact1
NOACT2	QIndiv[*].QEmploy.noact2
NOBACK9	QIndiv[*].QWorkRelatedIll.NOBACK9
NOLOWM18	QIndiv[*].QUnemploy.NoLoWM18
NOLOWM18_OTH	QIndiv[*].QUnemploy.NoLoWM18Oth
NonUK_Deg	QIndiv[*].QEdu.NonUK_Deg
NonUK_Other_Qual	QIndiv[*].QEdu.NonUK_Other_Qual
NonUK_School	QIndiv[*].QEdu.NonUK_School
NOVOUCH	QOutro.Email
number_employees_self_employed_1_to_10_1job	QIndiv[*].QEmploy.number_employees_self_employed_1_to_10_1job
number_employees_self_employed_1_to_10_main_2job	QIndiv[*].QEmploy.number_employees_self_employed_1_to_10_main_2job
number_employees_self_employed_1_to_10_previous_job	QIndiv[*].QEmploy.number_employees_self_employed_1_to_10_previous_job
number_employees_self_employed_1_to_10_second_2job	QIndiv[*].QEmploy.number_employees_self_employed_1_to_10_second_2job
number_employees_self_employed_1job	QIndiv[*].QEmploy.number_employees_self_employed_1job
number_employees_self_employed_1job_dont_know_bands	QIndiv[*].QEmploy.number_employees_self_employed_1job_dont_know_bands
number_employees_self_employed_1job_tel	QIndiv[*].QEmploy.number_employees_self_employed_1job_tel
number_employees_self_employed_main_2job	QIndiv[*].QEmploy.number_employees_self_employed_main_2job
number_employees_self_employed_main_2job_dont_know_bands	QIndiv[*].QEmploy.number_employees_self_employed_main_2job_dont_know_bands
number_employees_self_employed_main_2job_tel	QIndiv[*].QEmploy.number_employees_self_employed_main_2job_tel
number_employees_self_employed_previous_job	QIndiv[*].QPrevIndOCc.number_employees_self_employed_previous_job
number_employees_self_employed_previous_job_dont_know_bands	QIndiv[*].QPrevIndOCc.number_employees_self_employed_previous_job_dont_know_bands
number_employees_self_employed_previous_job_tel	QIndiv[*].QPrevIndOCc.number_employees_self_employed_previous_job_tel
number_employees_self_employed_second_2job	QIndiv[*].QEmploy.number_employees_self_employed_second_2job
number_employees_self_employed_second_2job_dont_know_bands	QIndiv[*].QEmploy.number_employees_self_employed_second_2job_dont_know_bands
number_employees_self_employed_second_2job_tel	QIndiv[*].QEmploy.number_employees_self_employed_second_2job_tel
number_employees_workplace_1_to_10_1job	QIndiv[*].QEmploy.number_employees_workplace_1_to_10_1job
number_employees_workplace_1_to_10_main_2job	QIndiv[*].QEmploy.number_employees_workplace_1_to_10_main_2job
number_employees_workplace_1_to_10_previous_job	QIndiv[*].QEmploy.number_employees_workplace_1_to_10_previous_job
number_employees_workplace_1_to_10_second_2job	QIndiv[*].QEmploy.number_employees_workplace_1_to_10_second_2job
number_employees_workplace_1_to_10_ufw	QIndiv[*].QEmploy.number_employees_workplace_1_to_10_ufw
number_employees_workplace_1job	QIndiv[*].QEmploy.number_employees_workplace_1job
number_employees_workplace_1job_tel	QIndiv[*].QEmploy.number_employees_workplace_1job_tel
number_employees_workplace_1job_dont_know_bands	QIndiv[*].QEmploy.number_employees_workplace_1job_dont_know_bands
number_employees_workplace_main_2job	QIndiv[*].QEmploy.number_employees_workplace_main_2job
number_employees_workplace_main_2job_dont_know_bands	QIndiv[*].QEmploy.number_employees_workplace_main_2job_dont_know_bands
number_employees_workplace_previous_job	QIndiv[*].QPrevIndOCc.number_employees_workplace_previous_job
number_employees_workplace_previous_job_tel	QIndiv[*].QPrevIndOCc.number_employees_workplace_previous_job_tel
number_employees_workplace_previous_job_dont_know_bands	QIndiv[*].QPrevIndOCc.number_employees_workplace_previous_job_dont_know_bands
number_employees_workplace_main_2job_tel	QIndiv[*].QEmploy.number_employees_workplace_main_2job_tel
number_employees_workplace_second_2job	QIndiv[*].QEmploy.number_employees_workplace_second_2job
number_employees_workplace_second_2job_dont_know_bands	QIndiv[*].QEmploy.number_employees_workplace_second_2job_dont_know_bands
number_employees_workplace_second_2job_tel	QIndiv[*].QEmploy.number_employees_workplace_second_2job_tel
number_employees_workplace_ufw	QIndiv[*].QEmploy.number_employees_workplace_ufw
number_employees_workplace_ufw_tel	QIndiv[*].QEmploy.number_employees_workplace_ufw_tel
number_employees_workplace_dont_know_bands_ufw	QIndiv[*].QEmploy.number_employees_workplace_dont_know_bands_ufw
number_employees_workplace_1_to_10_ufw	QIndiv[*].QEmploy.number_employees_workplace_1_to_10_ufw
number_of_extra_weekly_hours_preferred	QIndiv[*].QOverUnderEmp.number_of_extra_weekly_hours_preferred
number_of_less_hours_preferred_main_job	QIndiv[*].QOverUnderEmp.number_of_less_hours_preferred_main_job
NUMILL	QIndiv[*].QWorkRelatedIll.NUMILL
Nursing_Qual	QIndiv[*].QEdu.Nursing_Qual
NVQ_Af2015	QIndiv[*].QEdu.NVQ_Af2015
NVQ_Pre2015	QIndiv[*].QEdu.NVQ_Pre2015
NVQ_Year	QIndiv[*].QEdu.NVQ_Year
OPAUTH20	QIndiv[*].QEmploy.OpAuth20
OPAUTH21	QIndiv[*].QEmploy.OpAuth21
OPAUTH22	QIndiv[*].QEmploy.OpAuth22
oth_benefits_claiming	QIndiv[*].QBenefits.oth_benefits_claiming
OthAddType	QHousehold.QHHoldConfirm.OthAddType[*]
OTHER	QIndiv[*].QEthnic.EthAnoth
Other_expired_passport	QIndiv[*].QPassport.Multi_expired_passport[**]
Other_Lower_Lev	QIndiv[*].QEdu.Other_Lower_Lev
OTHER_Oth	QIndiv[*].QEthnic.EthAntOth
Other_passport	QIndiv[*].QPassport.Multi_current_passport[**]
Other_Qual	QIndiv[*].QEdu.Other_Qual
Other_Qual_NonUK	QIndiv[*].QEdu.Other_Qual_NonUK
Other_Uni_Lev	QIndiv[*].QEdu.Other_Uni_Lev
OUTRO	QOutro.Email
OUTRO1	QOutro.EmailChk
OUTRO2	QOutro.Outro2
OUTRO2a	QOutro.Outro2
OUTRO3a	QOutro.Outro3a
OUTRO3b	QOutro.Outro3b
OUTWRK	QIndiv[*].QEmploy.OutWrk
OWNBUS18	QIndiv[*].QEmploy.OwnBus18
OWNBUS18_Catch	QIndiv[*].QEmploy.QCatchUnemp.ctchOwnBus18
OWNBUS18_Catch_Int1	QIndiv[*].QEmploy.QCatchUnemp.ctchOwnBus18Int1
OWNBUS18_Catch_Int2	QIndiv[*].QEmploy.QCatchUnemp.ctchOwnBus18Int2
OWNBUS18_Int1	QIndiv[*].QEmploy.OwnBus18Int1
OWNBUS18_Int2	QIndiv[*].QEmploy.OwnBus18Int2
Own_Run_Business_Check	QIndiv[*].QUnemploy.Own_Run_Business_Check
paid_different_to_usual	QIndiv[*].QVarInPay.Paid_different_to_usual
paid_less_than_usual_reason_main_job	QIndiv[*].QVarInPay.paid_less_than_usual_reason_main_job
paid_same_as_usual	QIndiv[*].QVarInPay.Paid_same_as_usual
paid_vary_reason_main_job	QIndiv[*].QVarInPay.paid_vary_reason_main_job
Paid_wage_employee_20	QIndiv[*].QEmploy.Paid_wage_emp_20
Paid_wage_employee_20	QIndiv[*].QEmploy.Paid_wage_employee_20
Paid_wage_employee_21	QIndiv[*].QEmploy.Paid_wage_emp_21
Paid_wage_employee_22	QIndiv[*].QEmploy.Paid_wage_emp_22
Paid_wage_self_employed_20	QIndiv[*].QEmploy.Paid_self_employed_20
Paid_wage_self_employed_21	QIndiv[*].QEmploy.Paid_wage_self_emp_21
Paid_wage_self_employed_22	QIndiv[*].QEmploy.Paid_wage_self_emp_22
PAIDJOB	QIndiv[*].QUnemploy.PaidJob_Original
PAIDJOB_EDU	QIndiv[*].QCourse.PaidJob
PARTNER20	QIndiv[*].QEmploy.Partner20
PARTNER21	QIndiv[*].QEmploy.Partner21
PARTNER22	QIndiv[*].QEmploy.Partner22
past_illnesses_reduced_activity	QIndiv[*].QHealth.past_illness_reduced_activity
past_joint_bone_muscle_conditions	QIndiv[*].QHealth.past_joint_bone_muscle_conditions
past_long_lasting_health_condition_intro	Skip
past_long_lasting_health_condition	QIndiv[*].QHealth.past_long_lasting_health_condition
past_mental_health_conditions	QIndiv[*].QHealth.past_mental_health_conditions
past_physical_conditions	QIndiv[*].QHealth.past_physical_conditions
PAUSE
PAYINTRO	Skip
PAYINTRO_TO	QIndiv[*].QEarnings.PayIntro
Person
POT	QIndiv[*].QEmploy.POT_Hours
POT1	QIndiv[*].QEmploy.POT1_Hours
POT2	QIndiv[*].QEmploy.POT2_Hours
Previous
previously_served_armed_forces	QIndiv[*].QVeterans.previously_served_armed_forces_Pers
previously_served_armed_forces_Proxy	QIndiv[*].QVeterans.previously_served_armed_forces_Prox
ProxyCheck	QIndiv[*].QPersProx.Rspndnt
PTHRS	QIndiv[*].QEarnings.PTHrs
PTHRS2B	QIndiv[*].QEarnings.PTHrs2B
QHEALTH1	QIndiv[*].QHealth.QHealth1
QSTAY	QIndiv[*].QCntryBrth.QStay
Qual_Check	QIndiv[*].QEdu.Qual_Check
Qual_Check_EWNINonUK	QIndiv[*].QEdu.Qual_EWNINonUK
Qual_Check_EWNISCOT	QIndiv[*].QEdu.Qual_Check_EWNISCOT
Qual_Check_EWNIScotNonUK	QIndiv[*].QEdu.Qual_EWNIScotNonUK
Qual_Check_NonUK	QIndiv[*].QEdu.Qual_Check_NonUK
Qual_Check_Scot	QIndiv[*].QEdu.Qual_Check_Scot
REASOFF91	QIndiv[*].QWorkRelatedIll.REASOFF91
REASOFF92	QIndiv[*].QWorkRelatedIll.REASOFF92
REASOFF93	QIndiv[*].QWorkRelatedIll.REASOFF93
reason_made_redundant	QIndiv[*].QPrevIndOCc.reason_made_redundant
RECEIPT	Skip
REDACT	QIndiv[*].QHealth.RedAct
REDANY	QIndiv[*].QPrevIndOCc.RedAny
REDPAID	QIndiv[*].QPrevIndOCc.RedPaid
REDYL18	QIndiv[*].QPrevIndOCc.REDYL18
Rel to P1	QHousehold.QHHold.Person[*].Relate
Relationships	QHousehold.QRelGrid.QTAskRel.QBRelGrid[*].Rel[**]
RelExPage	Skip
RELIGION	QIndiv[*].QReligion.Relig
RELIGION_Oth	QIndiv[*].QReligion.ReligOth
RELIGION_SC	QIndiv[*].QReligion.ReligionS
RELIGION_SC_OTH	QIndiv[*].QReligion.ReligOth
RELIGIONNI1	QIndiv[*].QReligion.ReligionNI1
RELIGIONNI1_OTH	QIndiv[*].QReligion.ReligOth
RELIGIONNI2	QIndiv[*].QReligion.ReligionNI2
RELIGIONNI2_OTH	QIndiv[*].QReligion.ReligOth2
ROAD	QIndiv[*].QAccidAtWork.Road
RSA_Cert_Level	QIndiv[*].QEdu.RSA_Cert_Level
RSA_Dip_Level	QIndiv[*].QEdu.RSA_Dip_Level
RSA_ICT_Lev	QIndiv[*].QEdu.RSA_ICT_Lev
RSA_OCR	QIndiv[*].QEdu.RSA_OCR
RTNEMP	QIndiv[*].QEmploy.RTNEmp
Safety_Net_BTEC_Followup_awards	QIndiv[*].QEdu.Safety_Net_Followup_BTEC.Safety_Net_Followup_awards
Safety_Net_BTEC_Followup_Certs	QIndiv[*].QEdu.Safety_Net_Followup_BTEC.Safety_Net_Followup_Certs
Safety_Net_BTEC_Followup_Dips	QIndiv[*].QEdu.Safety_Net_Followup_BTEC.Safety_Net_Followup_Dips
Safety_Net_BTEC_Followup_DK	QIndiv[*].QEdu.Safety_Net_Followup_BTEC.Safety_Net_Followup_DK
Safety_Net_EdEx_Followup_awards	QIndiv[*].QEdu.Safety_Net_Followup_EdEx.Safety_Net_Followup_awards
Safety_Net_EdEx_Followup_Certs	QIndiv[*].QEdu.Safety_Net_Followup_EdEx.Safety_Net_Followup_Certs
Safety_Net_EdEx_Followup_Dips	QIndiv[*].QEdu.Safety_Net_Followup_EdEx.Safety_Net_Followup_Dips
Safety_Net_EdEx_Followup_DK	QIndiv[*].QEdu.Safety_Net_Followup_EdEx.Safety_Net_Followup_DK
Safety_Net_EWNINonUK	QIndiv[*].QEdu.Safety_Net_EWNINonUK
Safety_Net_EWNIScotNonUK	QIndiv[*].QEdu.Safety_Net_EWNIScotNonUK
Safety_Net_Level_Awards	QIndiv[*].QEdu.Safety_Net_Level_Awards
Safety_Net_Level_Certs	QIndiv[*].QEdu.Safety_Net_Level_Certs
Safety_Net_Level_Dips	QIndiv[*].QEdu.Safety_Net_Level_Dips
Safety_Net_Level_Other	QIndiv[*].QEdu.Safety_Net_Level_Other
Safety_Net_LQL_Followup_awards	QIndiv[*].QEdu.Safety_Net_Followup_LQL.Safety_Net_Followup_awards
Safety_Net_LQL_Followup_Certs	QIndiv[*].QEdu.Safety_Net_Followup_LQL.Safety_Net_Followup_Certs
Safety_Net_LQL_Followup_Dips	QIndiv[*].QEdu.Safety_Net_Followup_LQL.Safety_Net_Followup_Dips
Safety_Net_LQL_Followup_DK	QIndiv[*].QEdu.Safety_Net_Followup_LQL.Safety_Net_Followup_DK
Safety_Net_Nursing_Followup_awards	QIndiv[*].QEdu.Safety_Net_Followup_Nursing.Safety_Net_Followup_awards
Safety_Net_Nursing_Followup_Certs	QIndiv[*].QEdu.Safety_Net_Followup_Nursing.Safety_Net_Followup_Certs
Safety_Net_Nursing_Followup_Dips	QIndiv[*].QEdu.Safety_Net_Followup_Nursing.Safety_Net_Followup_Dips
Safety_Net_Nursing_Followup_DK	QIndiv[*].QEdu.Safety_Net_Followup_Nursing.Safety_Net_Followup_DK
Safety_Net_Q	QIndiv[*].QEdu.Safety_Net_Q
Safety_Net_ScotNonUK	QIndiv[*].QEdu.Safety_Net_ScotNonUK
Safety_Net_Size_BTEC	QIndiv[*].QEdu.Safety_Net_Followup_BTEC.Safety_Net_Size
Safety_Net_Size_EdEx	QIndiv[*].QEdu.Safety_Net_Followup_EdEx.Safety_Net_Size
Safety_Net_Size_LQL	QIndiv[*].QEdu.Safety_Net_Followup_LQL.Safety_Net_Size
Safety_Net_Size_Nursing	QIndiv[*].QEdu.Safety_Net_Followup_Nursing.Safety_Net_Size
SATIS	QIndiv[*].QWellbeing.Satis
satisfaction_main_job	QIndiv[*].QJobQual.satisfaction_main_job
Scot_AddHE_Other	QIndiv[*].QEdu.Scot_AddHE_Other
Scot_AddLea_Other	QIndiv[*].QEdu.Scot_AddLea_Other
Scot_AddSch_Other	QIndiv[*].QEdu.Scot_AddSch_Other
Scot_App	QIndiv[*].QEdu.Scot_App
Scot_Bacc	QIndiv[*].QEdu.Scot_Bacc
Scot_HigherEd	QIndiv[*].QEdu.Scot_HigherEd
Scot_Int_Bacc	QIndiv[*].QEdu.Scot_Int_Bacc
Scot_leavers	QIndiv[*].QEdu.Scot_leavers
Scot_Other	QIndiv[*].QEdu.Scot_Other
Scot_School	QIndiv[*].QEdu.Scot_School
Scot_Skills	QIndiv[*].QEdu.Scot_Skills
SCOTVEC_Type	QIndiv[*].QEdu.SCOTVEC_Type
SCQF_Lev	QIndiv[*].QEdu.SCQF_Lev
SecGrs	QIndiv[*].QEarnings.SecGrs
SecGrsExp	QIndiv[*].QEarnings.SecGrsExp
SECJOB	QIndiv[*].QEmploy.SecJob
SECTOR	QIndiv[*].QEmploy.Sector
SECTOR03	QIndiv[*].QEmploy.Sector03
SECTOR03_OTH	QIndiv[*].QEmploy.Sector03Oth
self_union_membership	QIndiv[*].QJobQual.self_union_membership
SETPROXY
SEX	QHousehold.QHHold.Person[*].Sex
Sexual_Orientation	QIndiv[*].QSID.Sexual_Orientation
Sexual_Orientation_Oth	QIndiv[*].QSID.Sexual_Orientation_Oth
SFW_Lev	QIndiv[*].QEdu.SFW_Lev
ShareCooking	QHousehold.QHHoldConfirm.ShareCook
ShareLiv	QHousehold.QHHoldConfirm.ShareLiv
shorter_hours_less_pay	QIndiv[*].QOverUnderEmp.shorter_hours_less_pay
shorter_hours_less_pay_main_job	QIndiv[*].QOverUnderEmp.shorter_hours_less_pay_main_job
shorter_hours_preferred_main_job	QIndiv[*].QOverUnderEmp.shorter_hours_preferred_main_job
sic2007_employed_main_job	QIndiv[*].QEmploy.sic2007_employed_main_job
sic2007_employed_second_job	QIndiv[*].QEmploy.sic2007_employed_second_job
sic2007_industry_employed_previous_job	QIndiv[*].QPrevIndOCc.sic2007_industry_employed_previous_job
sic2007_industry_employed_redundant_job	QIndiv[*].QPrevIndOCc.sic2007_industry_employed_redundant_job
sic2007_industry_self_employed_previous_job	QIndiv[*].QPrevIndOCc.sic2007_industry_self_employed_previous_job
sic2007_self_employed_main_job	QIndiv[*].QEmploy.sic2007_self_employed_main_job
sic2007_unpaid_family_worker	QIndiv[*].QEmploy.sic2007_unpaid_family_worker
sic2007_self_employed_second_job	QIndiv[*].QEmploy.sic2007_self_employed_second_job
sickness_continuous_absence_length	QIndiv[*].QSickness.sickness_continuous_absence_length
sickness_continuous_absence_length_over_2_months	QIndiv[*].QSickness.sickness_continuous_absence_length_over_2_months
sickness_continuous_absence_length_tel	QIndiv[*].QSickness.sickness_continuous_absence_length_tel
sickness_continuous_absence_length_under_2_months	QIndiv[*].QSickness.sickness_continuous_absence_length_under_2_months
sickness_disability_benefits_claiming	QIndiv[*].QBenefits.sickness_disability_benefits_claiming
SITEFR	QIndiv[*].QAccidAtWork.SiteFr
skills_match_main_job	QIndiv[*].QJobQual.skills_match_main_job
Skills_Type	QIndiv[*].QEdu.Skills_Type
SMEARNER	QIndiv[*].QSocialMob.SMEarner
SMERESE	QIndiv[*].QSocialMob.SMERESE
SMHCOMP	QIndiv[*].QSocialMob.SMHComp
SMOCCD	QIndiv[*].QSocialMob.SMOccD
SMOCCT	QIndiv[*].QSocialMob.SMOccT
SMOYArea	QIndiv[*].QSocialMob.SMOYAreaPers
SMOYArea_Proxy	QIndiv[*].QSocialMob.SMOYAreaProx
SMOYCty	QIndiv[*].QSocialMob.SMOYCty
SNAPSHOT	Skip
SOC2020_2_PT1	QIndiv[*].QEmploy.SOC_2020_2_Pt1
SOC2020_2_PT2	QIndiv[*].QEmploy.SOC_2020_2_Pt2
soc2020_job_description_previous_job	QIndiv[*].QPrevIndOCc.soc2020_job_description_previous_job
soc2020_job_description_redundant_job	QIndiv[*].QPrevIndOCc.soc2020_job_description_redundant_job
soc2020_job_description_unpaid_family_worker	QIndiv[*].QEmploy.soc2020_job_description_unpaid_family_worker
soc2020_job_title_check_redundant_job	QIndiv[*].QPrevIndOCc.soc2020_job_title_check_redundant_job
soc2020_job_title_redundant_job	QIndiv[*].QPrevIndOCc.soc2020_job_title_redundant_job
soc2020_job_title_previous_job	QIndiv[*].QPrevIndOCc.soc2020_job_title_previous_job
soc2020_job_title_unpaid_family_worker	QIndiv[*].QEmploy.soc2020_job_title_unpaid_family_worker
SOC2020PT1	QIndiv[*].QEmploy.SOC_2020_Pt1
SOC2020PT2	QIndiv[*].QEmploy.SOC_2020_Pt2
Standards_Lev	QIndiv[*].QEdu.Standards_Lev
START18	QIndiv[*].QUnemploy.Start18
START18_Catch	QIndiv[*].QEmploy.QCatchUnemp.ctchStart18
START182	QIndiv[*].QUnemploy.Start182
START183	QIndiv[*].QEmploy.Start183
STAT	QIndiv[*].QEmploy.Stat
STAT1	QIndiv[*].QEmploy.Stat1
STAT2	QIndiv[*].QEmploy.Stat2_18
state_pension_receiving	QIndiv[*].QBenefits.state_pension_receiving
STATUNEMP	QIndiv[*].QUnemploy.StatUnemp
statutory_sick_pay_receiving	QIndiv[*].QSickness.statutory_sick_pay_receiving
StopTest	Skip
StudentChk	QHousehold.QHHold.Person[*].StudentChk
StuRel	QHousehold.QHHold.Person[*].Relate
supervisory_duties_1job	QIndiv[*].QEmploy.supervisory_duties_1job
supervisory_duties_main_2job	QIndiv[*].QEmploy.supervisory_duties_main_2job
supervisory_duties_second_2job	QIndiv[*].QEmploy.supervisory_duties_second_2job
supervisory_duties_previous_job	QIndiv[*].QPrevIndOCc.supervisory_duties_previous_job
SVQ_Lev	QIndiv[*].QEdu.SVQ_Lev
SVQLev_3	QIndiv[*].QEdu.SVQLev_3
SVQLev_4	QIndiv[*].QEdu.SVQLev_4
Teach_Age	QIndiv[*].QEdu.Teach_Age
Teaching_Qual	QIndiv[*].QEdu.Teaching_Qual
Tech_Lev	QIndiv[*].QEdu.Tech_Lev
TempJob18	QIndiv[*].QEmploy.TempJob18
TEN1	QHousehold.QHHoldConfirm.Ten1
TEN1SomeoneElse	QHousehold.QHHoldConfirm.Ten1Else
TEN1SomeoneElse_OTH	QHousehold.QHHoldConfirm.Ten1ElseOth
think_work_in_future	QIndiv[*].QUnemploy.think_work_in_future
TIED	QHousehold.QHHoldConfirm.Tied
TimeAway	QIndiv[*].QLiveHere.TimeAway
TimeAway_TO	QHousehold.QHHoldConfirm.TimeAway[*]
TIMEDAYS	QIndiv[*].QAccidAtWork.TimeDays
TIMEOFF	QIndiv[*].QWorkRelatedIll.TimeOff
TIMEOFF_PROXY	QIndiv[*].QWorkRelatedIll.TimeOffPers
TOTAC1	QIndiv[*].QEmploy.TotAc1
TOTAC2	QIndiv[*].QEmploy.TotAc2
Total_DUR3_MTH	QIndiv[*].QEmploy.Total_Dur3_Mth
TPBN20	QIndiv[*].QBenefits.TPBN20
TRVDRV	QIndiv[*].QTravToWork.TrvDrv
TRVMTH	QIndiv[*].QTravToWork.TrvMth
TRVTME	QIndiv[*].QTravToWork.TrvTmePers
TRVTME_PROXY	QIndiv[*].QTravToWork.TrvTmeProx
TYPILL	QIndiv[*].QWorkRelatedIll.TYPILL
TYPINJ	QIndiv[*].QAccidAtWork.TypInj
uc_reason_claiming	QIndiv[*].QBenefits.uc_reason_claiming
UCREDIT20	QIndiv[*].QBenefits.UCredit20
uk_armed_forces_year_left	QIndiv[*].QVeterans.uk_armed_forces_year_left
UNION	QIndiv[*].QJobQual.workplace_union_membership
union_affects_pay_and_conditions	QIndiv[*].QJobQual.union_affects_pay_and_conditions
UPDATE_CURRENT_PASSPORTS	Skip
UPDATE_EXPIRED_PASSPORTS	Skip
UPDATE_MAX_PEOPLE	Skip
UPDATE_PEOPLE	Skip
UPOT	QIndiv[*].QEmploy.UpOT_Hours
UPOT1	QIndiv[*].QEmploy.UpOT1_Hours
UPOT2	QIndiv[*].QEmploy.UpOT2_Hours
USHR	QIndiv[*].QEmploy.UsHr_Hours
USHR1	QIndiv[*].QEmploy.UsHr1_Hours
USHR1_NOACT	QIndiv[*].QEmploy.UsHr1
USHR2	QIndiv[*].QEmploy.UsHr2_Hours
USHR2_NOACT	QIndiv[*].QEmploy.UsHr2
usual_paid_overtime_1job_hours	QIndiv[*].QEmploy.usual_paid_overtime_1job_hours
usual_paid_overtime_main_2job_hours	QIndiv[*].QEmploy.usual_paid_overtime_main_2job_hours
usual_paid_overtime_nwrw_1job_hours	QIndiv[*].QEmploy.usual_paid_overtime_nwrw_1job_hours
usual_paid_overtime_nwrw_main_2job_hours	QIndiv[*].QEmploy.usual_paid_overtime_nwrw_main_2job_hours
usual_paid_overtime_nwrw_second_2job_hours	QIndiv[*].QEmploy.usual_paid_overtime_nwrw_second_2job_hours
usual_paid_overtime_second_2job_hours	QIndiv[*].QEmploy.usual_paid_overtime_second_2job_hours
usual_unpaid_family_worker_hours	QIndiv[*].QEmploy.usual_unpaid_family_worker_hours
usual_unpaid_overtime_1job_hours	QIndiv[*].QEmploy.usual_unpaid_overtime_1job_hours
usual_unpaid_overtime_main_2job_hours	QIndiv[*].QEmploy.usual_unpaid_overtime_main_2job_hours
usual_unpaid_overtime_nwrw_1job_hours	QIndiv[*].QEmploy.usual_unpaid_overtime_nwrw_1job_hours
usual_unpaid_overtime_nwrw_main_2job_hours	QIndiv[*].QEmploy.usual_unpaid_overtime_nwrw_main_2job_hours
usual_unpaid_overtime_nwrw_second_2job_hours	QIndiv[*].QEmploy.usual_unpaid_overtime_nwrw_second_2job_hours
usual_unpaid_overtime_second_2job_hours	QIndiv[*].QEmploy.usual_unpaid_overtime_second_2job_hours
usual_work_pattern_time_periods_main_job	QIndiv[*].QEmploy.usual_work_pattern_time_periods_main_job
WAIT	QIndiv[*].QUnemploy.Wait
want_longer_hours_not_looking_reasons	QIndiv[*].QOverUnderEmp.want_longer_hours_not_looking_reasons
WCHJB	QIndiv[*].QAccidAtWork.WchJb
WCHJB3	QIndiv[*].QWorkRelatedIll.WCHJB3
Welsh Language	QIndiv[*].QWelsh.WelshLang
Welsh_Bacc	QIndiv[*].QEdu.Welsh_Bacc
WHCDAYS18	QIndiv[*].QEmploy.WhichDays18
when_think_work_in_future	QIndiv[*].QUnemploy.when_think_work_in_future
WHITE
WHITE_en	QIndiv[*].QEthnic.EthEWh
WHITE_ni	QIndiv[*].QEthnic.EthNWh
WHITE_OTH	QIndiv[*].QEthnic.EthWWhOth
WHITE_OTH_EN	QIndiv[*].QEthnic.EthEWhOth
WHITE_OTH_SC	QIndiv[*].QEthnic.EthSWhOth
WHITE_OTH_WA	QIndiv[*].QEthnic.EthWWhOth
WHITE_sco	QIndiv[*].QEthnic.EthSWh
WHITE_wal	QIndiv[*].QEthnic.EthWWh
WhyCas18	QIndiv[*].QUnemploy.WhyCas18
WhyCas18_Emp	QIndiv[*].QEmploy.WhyCas18
WhyCas18_Emp_Oth	QIndiv[*].QEmploy.WhyCas18Oth
WhyCas18_Oth	QIndiv[*].QUnemploy.WhyCas18Oth
WhyTemp18	QIndiv[*].QEmploy.WhyTemp18
WhyTemp18_Oth	QIndiv[*].QEmploy.WhyTemp18Oth
WHYUK10	QIndiv[*].QCntryBrth.WhyUK10
WKBANDS1A	QIndiv[*].QEarnings.WkBands1A
WKBANDS1B	QIndiv[*].QEarnings.WkBands1B
WKBANDS2	QIndiv[*].QEarnings.WkBands2
WKBANDS3	QIndiv[*].QEarnings.WkBands3
WKPL99	QIndiv[*].QTravToWork.WkPl99
WKSK4	QIndiv[*].QSickness.WKSK4
work_illness_most_serious_time_off_length	QIndiv[*].QWorkRelatedIll.work_illness_most_serious_time_off_length
work_illness_most_serious_time_off_length_tel	QIndiv[*].QWorkRelatedIll.work_illness_most_serious_time_off_length_tel
work_illness_time_off_length	QIndiv[*].QWorkRelatedIll.work_illness_time_off_length
work_illness_time_off_length_days	QIndiv[*].QWorkRelatedIll.work_illness_time_off_length_days
work_illness_time_off_length_months	QIndiv[*].QWorkRelatedIll.work_illness_time_off_length_months
work_illness_time_off_length_tel	QIndiv[*].QWorkRelatedIll.work_illness_time_off_length_tel
work_illness_time_off_length_weeks	QIndiv[*].QWorkRelatedIll.work_illness_time_off_length_weeks
work_illness_type_one	QIndiv[*].QWorkRelatedIll.work_illness_type_one
work_illness_which_job_unemployed	QIndiv[*].QWorkRelatedIll.work_illness_which_job_unemployed
work_location_job	QIndiv[*].QEmploy.Work_Locn_Job
work_location_second_job	QIndiv[*].QEmploy.work_location_second_job
work_related_education_3months	QIndiv[*].QCourse.work_related_education_3months
work_related_education_4weeks	QIndiv[*].QCourse.work_related_education_4weeks
workplace_location_second_job	QIndiv[*].QTravToWork.Workplace_Location_Second_Job
workplace_union_membership	QIndiv[*].QJobQual.workplace_union_membership
WORTH	QIndiv[*].QWellbeing.Worth
WP_CMPL	QIndiv[*].QEmploy.WP_Cmpl
WP_CMPL_OTH	QIndiv[*].QEmploy.WP_Cmpl_Oth
WP_HRisk	QIndiv[*].QEmploy.WP_HRisk
XMARSTA	QIndiv[*].QMarSta.xMarSta
YDifJb_emp	QIndiv[*].QEmploy.YDifJb_Emp
YDifJb_emp_Oth	QIndiv[*].QEmploy.YDifJbEmpOth
YDifJb_semp	QIndiv[*].QEmploy.YDifJb_SEmp
YDifJb_semp_Oth	QIndiv[*].Qemploy.YDifJb_SEmpOth
YLESS.EMP	QIndiv[*].QEmploy.YLessEmp
YLESS.EMP_Oth	QIndiv[*].QEmploy.YLessEmpOth
YLESS.SEMP	QIndiv[*].QEmploy.YLessSEmp
YLESS.SEMP_Oth	QIndiv[*].QEmploy.YLessSEmpOth
YPayL20a	QIndiv[*].QVarInPay.YPayL20a
Yptjob18	QIndiv[*].QEmploy.YPTJob18
Yptjob18_Oth	QIndiv[*].QEmploy.YPTJob18Oth
YSTART18	QIndiv[*].QUnemploy.YStart18
YSTART18_Oth	QIndiv[*].QUnemploy.YStart18Oth
YVary99	QIndiv[*].QVarInPay.YVary99
ZHC20	QIndiv[*].QEmploy.ZeroHours20