Person	4
UPDATE_EXPIRED_PASSPORTS	1
UPDATE_CURRENT_PASSPORTS	1
UPDATE_MAX_PEOPLE	4
UPDATE_PEOPLE	[['1', '1'], ['2', '1'], ['3', '1'], ['4', '1']]
Rel to P1	Brother or sister
HholdChk	Yes
Person	5
AddPpl	Urbosa IP162;;HH150 Gerudo
Sex	Female
Rel to P1	Sister or brother
HholdChk	Yes
Person	6
AddPpl	Mipha IP163;;HH150 Zora
Sex	Female
Rel to P1	Sister or brother
HholdChk	No
HholdChk2	Yes
StudentChk	None of these people live in a student halls of residence
RelExPage	Save and continue
Relationships	2;3;Other non-relative
Relationships	2;4;
Relationships	2;5;Other non-relative
Relationships	2;6;Other non-relative
Relationships	3;4;Other non-relative
Relationships	3;5;Other non-relative
Relationships	3;6;Other non-relative
Relationships	4;5;Other non-relative
Relationships	4;6;Other non-relative
Relationships	5;6;Other non-relative
ShareCooking	Yes
ShareLiv	No
HRP	Someone else not listed above
TEN1SomeoneElse	Squatting
Person	6
IndivIntroPage	
SETPROXY	No
ProxyCheck	Mipha IP163 HH150 Zora
AltAdd	No
DOB	1;1;1990
XMARSTA	Never married and never legally registered in a civil partnership 
Nationality	British
CRY12	Northern Ireland
NATID	Northern Irish
Ethnicity	White
WHITE	Irish
RELIGION_SC	Other Christian
Current_passports	None
Expired_passports	None
Sexual_Orientation	Gay or Lesbian
PAIDJOB	No
Own_Run_Business_Check	No
CasualJob20	No
LOOK4_18	No
NOLOWM18	Waiting for the results of a job application
like_paid_job	Yes
MargAtch	Yes
think_work_in_future	Probably
when_think_work_in_future	More than five years
Comment	LEFTYR18 > 4 months but < 12 months
LEFTYR18	-8m;-8m
work_unpaid	No
REDYL18	Made redundant
HTHDIS	Yes
employment_status_previous	Self-employed
soc2020_job_title_previous_job	Life guard
soc2020_job_description_previous_job	Guarding life
sic2007_industry_self_employed_previous_job	Swimming
number_employees_self_employed_previous_job	25-49
EMPSICK4	Yes
WKSK4	3
sickness_continuous_absence_length_under_2_months	At least six weeks but less than two months
ILNE20M	Other musculoskeletal problems
ILNE12SE	Employment
HWRET12E	Still on long term sickness absence
APPCURR	No
ENROL	No
future_work_related_education_3months	No
Enrol_Check	Yes
Country_Qual_Intro	Save and continue
Country_Qual	No qualifications have been gained in the past
sickness_disability_benefits_claiming	Industrial Injuries Disablement Benefit
oth_benefits_claiming	Council Tax Reduction Benefit
previously_served_armed_forces	No
SMOYArea	Prefer not to say
SMOYCty	Prefer not to say
SMHCOMP	Prefer not to say
QHEALTH1	Prefer not to say
SATIS	Prefer not to say
WORTH	Prefer not to say
HAPPY	Prefer not to say
ANXIOUS	Prefer not to say
LNGLST	Prefer not to say
past_long_lasting_health_condition_intro	
past_long_lasting_health_condition	Prefer not to say
ACCDNT	No
ILLWRK2	Yes
NUMILL	1
TYPILL	Heart disease, a heart attack or a circulatory system problem
AWARE	More than 12 months ago
work_illness_time_off_length	At least one month
work_illness_time_off_length_months	6
REASOFF91	No
CIGEVER	No
hh_refday	John BP0 HH150 Smith;Princess BP142 HH150 Zelda;Revali BP143 HH150 Rito;Daruk BP153 HH150 Goron;Urbosa IP162 HH150 Gerudo;Mipha IP163 HH150 Zora
hh_refday1	No
AddrHist_check	Yes
Individual_OUTRO	
CheckText	We would now like to ask some questions about each person